%%%%%%%%%%%%%%%%%%%%%%%%%%%%%%
%.      % % %G             %.%
%       % % %%%%%% %%%%%%% % %
%       %        %     % %   %
%%%%% %%%%% %%% %% %%%%% % %%%
%   % % % %   %G   %     %   %
% %%% % % % %%%%%%%% %%% %%% %
%       %     %%     % % %   %
%%% % %%%%%%% %%%% %%% % % % %
% %           %%     %     % %
% % %%%%% % %%%% % %%% %%% % %
%   %     %      % %   % %%% %
%.  %P%%%%%      % %%% %    .%
%%%%%%%%%%%%%%%%%%%%%%%%%%%%%%
